C 135,206,235
SO imgs/Wall1.xpm
EA imgs/Wall4.xpm



F 113,115,102
NO imgs/Wall2.xpm
WE imgs/Wall3.xpm


        1111111111111111111111111   1111
        1000000000110000000000001   101
        101100000111000000000001   1111
        100010000000000N000100001
11111111101100000111000000000001
100000000011000001110111111111111
11110111111111011100000010001
11110111111111011101010010001
10000000000000000000000000001
100000000000000000000000000001
11000000111111111000000100011
1000000001    1  1000000011011
10000000011111111101010010001
11000001111101011111011110001
11110111 1110101 101111010001
11111111 1111111 111111111111





